4:00,T1,T1.1,,
6:00,T2,T1,,
9:00,T3,T2,,
12:00,T4,T3,,
15:00,T4,T4,,
18:00,T4,T4,,
21:00,T5,T5,,
25:00,T6,T6,,
29:00,T7,T7,,
33:00,T7,T7,,
